J.alleles	Nucleotide.sequence
TRAJ10	ATACTCACGGGAGGAGGAAACAAACTCACCTTT
TRAJ11	TGAATTCAGGATACAGCACCCTCACCTTT
TRAJ12	GGATGGATAGCAGCTATAAATTGATCTTC
TRAJ13	TGAATTCTGGGGGTTACCAGAAAGTTACCTTT
TRAJ14	ATTTATAGCACATTCATCTTT
TRAJ15	CCAACCAGGCAGGAACTGCTCTGATCTTT
TRAJ16	GGTTTTCAGATGGCCAGAAGCTGCTCTTT
TRAJ17	TGATCAAAGCTGCAGGCAACAAGCTAACTTTT
TRAJ18	CCGACAGAGGCTCAACCCTGGGGAGGCTATACTTT
TRAJ20	GTTCTAACGACTACAAGCTCAGCTTT
TRAJ21	TACAACTTCAACAAATTTTACTTT
TRAJ22	TTTCTTCTGGTTCTGCAAGGCAACTGACCTTT
TRAJ23	TGATTTATAACCAGGGAGGAAAGCTTATCTTC
TRAJ24	TGACAACTGACAGCTGGGGGAAATTCGAGTTT
TRAJ26	GGGATAACTATGGTCAGAATTTTGTCTTT
TRAJ27	TAACACCAATGCAGGCAAATCAACCTTT
TRAJ28	CATACTCTGGGGCTGGGAGTTACCAACTCACTTTC
TRAJ29	GGAATTCAGGAAACACACCTCTTGTCTTT
TRAJ3	GGGGTACAGCAGTGCTTCCAAGATAATCTTT
TRAJ30	TGAACAGAGATGACAAGATCATCTTT
TRAJ31	GAATAACAATGCCAGACTCATGTTT
TRAJ32	TGAATTATGGCGGTGCTACAAACAAGCTCATCTTT
TRAJ33	TGGATAGCAACTATCAGTTAATCTGG
TRAJ34	TCTTATAACACCGACAAGCTCATCTTT
TRAJ36	TCAAACTGGGGCAAACAACCTCTTCTTT
TRAJ37	TGGCTCTGGCAACACAGGCAAACTAATCTTT
TRAJ38	TAATGCTGGCAACAACCGTAAGCTGATTTGG
TRAJ39	TGAATAATAATGCAGGCAACATGCTCACCTTT
TRAJ4	TGTTTTCTGGTGGCTACAATAAGCTGATTTTT
TRAJ40	ACTACCTCAGGAACCTACAAATACATCTTT
TRAJ41	GAACTCAAATTCCGGGTATGCACTCAACTTC
TRAJ42	TGAATTATGGAGGAAGCCAAGGAAATCTCATCTTT
TRAJ43	ACAATAACAATGACATGCGCTTT
TRAJ44	TAAATACCGGCACTGCCAGTAAACTCACCTTT
TRAJ45	TGTATTCAGGAGGAGGTGCTGACGGACTCACCTTT
TRAJ46	AGAAGAAAAGCAGCGGAGACAAGCTGACTTTT
TRAJ47	TGGAATATGGAAACAAACTGGTCTTT
TRAJ48	TATCTAACTTTGGAAATGAGAAATTAACCTTT
TRAJ49	GAACACCGGTAACCAGTTCTATTTT
TRAJ5	TGGACACGGGCAGGAGAGCACTTACTTTT
TRAJ50	TGAAAACCTCCTACGACAAGGTGATATTT
TRAJ52	CTAATGCTGGTGGTACTAGCTATGGAAAGCTGACATTT
TRAJ53	AGAATAGTGGAGGTAGCAACTATAAACTGACATTT
TRAJ54	TAATTCAGGGAGCCCAGAAGCTGGTATTT
TRAJ56	TTATACTGGAGCCAATAGTAAGCTGACATTT
TRAJ57	TAACTCAGGGCGGATCTGAAAAGCTGGTCTTT
TRAJ6	TGCATCAGGAGGAAGCTACATACCTACATTT
TRAJ7	TGACTATGGGAACAACAGACTCGCTTTT
TRAJ8	TGAACACAGGCTTTCAGAAACTTGTATTT
TRAJ9	GGAAATACTGGAGGCTTCAAAACTATCTTT